NO ./Images/XPM/NO.xpm
SO ./Images/XPM/SO.xpm
WE ./Images/XPM/WE.xpm
EA ./Images/XPM/EA.xpm
F 117,142,79
C 135,245,251


        1111111111111111111111111
        1000000000110000000000001
        1011000001110000N00000001
        1001000000000000000000001
111111111011000001110000000000001
100000000011000001110111111111111
11110111111111011100000010001
11110111111111011101010010001
11000000110101011100000010001
10000000000000001100000000001
10000000000000001101010010001
1100000111010101111101101000111111111111111111111112111111111111
11110100000001011111101000111110100011110101111110100011011011111
11111111111111101011100000010000000000001101010000000000100000111
1000000000000000110000001000000000000000000000000000000000111111
1111111011000001110000000000001111111111011000001110000000000001
100000000011000001110111111111111100000000011000001110111011111111
11110111000001011100000010001111101111111111011100000010001111101
111100000000000111010100100011111011        1   111111 111     11 
1111111111111111111111111111111111111111111111111111111111111111111
