

F 100,150,80    
C 50,100,200

NO imgs/wall_coquelicot.png
SO imgs/marble-yellow.png
WE imgs/wall_flower_yellow.png
EA imgs/wall_natural_yellow.png 




1111111111111111111
1000000000110000001
1011000001110000001  
1000100N00000000001
1121111111111111111