



NO imgs/cheese2.png
SO imgs/wine.png
WE imgs/cheese1.png
EA imgs/baguette.png 




1111111111111111111
1000000000110000001
1011000001211000001  
1000000000000000001
1000000000000000001
1000000000000000001
10000000000000000W1
1121111111111111111