NO imgs/falafel.png
SO imgs/palmtree.png
WE imgs/hummus.png
EA imgs/beach.png   



11111111111111111111111111111
10000000001100000000000000001
10110000011100000010000010001
10010000000000100000000010001
10110000011100000100000010011
10000000001100000111211110001
11110111111111011100000010001
11110111111111011101010010001
11000000110101011100000010001
10001000000000001100000020002
10000000000000001101010010001
10000000000000001101010010N01
11000000110101011111011110001
11110111111101011111011110001
11112111111111111111111111211
10000000000000001100000010001
10000000000000001101010010001
11111111111211111111111111111



