NO ./imgs/wall_ardoise.png
SO ./imgs/wall_ecaille_white.png
WE ./imgs/wall_dirty_pinkish.png
EA ./imgs/wall_metal_yellow.png
F 117,142,79
C 135,245,251


1111111111111111111111111     1111111111111111
1000000000000000000000001     1000000000000001
1000000000000000000000001     1111111111111101
1000000000000000000000001111111000000000000001
1000000000000000000000000000001000000000000111
100000000000000000000000000000100000000000N1
1000000000000000000000011111110011111111111
1000000000000000000111111     1001
10000000000000000001         1001
1111100000000000000111111111111001
1111100000000000000000000000000001
1111100000000000000000000000000001
1111111111111111111111111111111111
