NO imgs/wall_brick_beton.png
SO imgs/wall_concrete_grey.png
WE imgs/wall_mountains_green.png
EA imgs/wall_sky_building.png   


F 100,150,80     
C 50,100,200

11111
10001
10E01
10001
11111
