  NO imgs/eagle.png
SO imgs/colorstone.png
WE imgs/mossy.png
EA imgs/redbrick.png   


F 100,150,80     
C 50,100,200

1111111
1000001
1001001
10E0001
1000001
1000001
1111111




