NO imgs/wall_brick_beton.png
SO imgs/wall_concrete_grey.png
WE imgs/wall_mountains_green.png
EA imgs/wall_sky_building.png  
F 117,142,79
C 135,245,251


11111111111111
1S000000000001
10000000000001
11000000000001
10000000000001
10000111000001
10000111000001
10000000000001
10000000000001
10000000000001
10000000000001
11111111111111