

F 100,150,80    
C 50,100,200

NO imgs/dirt.png
SO imgs/colorstone.png
WE imgs/mossy.png
EA imgs/redbrick.png




1111111111111111111
1000000000110000001
1011000001110000001  
1100100N00000000001
1111111111111111111