NO imgs/dirt.png
SO imgs/colorstone.png
WE imgs/mossy.png
EA imgs/redbrick.png
F 100,150,80     
C 50,100,200
1111111111111111111
1000000000110000001
1011000001110000001     
100100000N000000001
1111111111111111111

