NO imgs/wall_brick_beton.png
WE imgs/wall_brick_blue.png
SO imgs/wall_bricks.png
EA imgs/wall_brick_white.png

F 20,22,25
C 13,14,15

1111111111111111111111111111111111111111111111111111111111111111111111111111111111111111111111111111111111111111111111111111111111111111111111111111111111111111111111111111111111111111111111111111111111111111111111111111111111111111111111111111111111111111111111111111111111111111111111111111111111
1000000010000000000000000000000000000000000000000000000000000000000000000000000000000000000000000000000000000000000000000000000000000000000000000000000000000000000000000000000000000000000000000000000000000100000001000000000001000000010000000010000100000000000000000000000000000000001110000000000001
1011111010110000001110101111101011111010111110101110000000000000000000000001101011111010111110101100000000000111010111000001010111110101111101011111010100001010111110101000000000101011111010000000000000101111101011111010111110101111101000010111110101111101011111010111110101000010000000000000000001
1111010000000000000000000000000000000000000000000010111110101111000000000000000000001010110000000000000000000000001110101111101011111010111110000000000000000000000000000000000000000000000000000000000000000001000000000000000000000000000000000000000000000000000000000000000000000000000000000000000001
1000000000000000000000000000000000000000000000000000000000000000101110000000000000000000000000000000000000000000011000010001000100010001000100010100010001000100010001000100010001000100010001000100010001000100010001000100010001000100010001000100010001000100010001000100010001000100010001000100010001
1000100010001000100010001000100010001000100010001000100010001000100010001000100010001000100010001000100010001000100010001000100010001000100000000100000000000000000000000000000000000000000000000000000000000000000000000000000000000000000000000000000000000000000000000000000000000000000000000000000001
1000000000000000000000000000000000000000000000000000111010110000000000000000000000000000011101011000000000000000000000000000011101000000000000000000100010001000000001000000000000000000000001110000000000001000100010001000100010001000111110101100000000000000000000000000000000000000000000000000011111
1101111101011111010111110101100000000000000000000000000000111010111100000000000000010100000000000000000000000000111110101111101011111000010001000100010001000100010001000100010001000100010001000100010001000100010001000100010001000100010001000100010001000100010001000100010001000100010001000100000001
1000000000000000000000000000000000000000000000000000000000000000000001111111111111111111111111111111000000000000000000000000000000000000000000000000000000000000000000000000000000000000000000000000000000000000000000000000000000000000000000000000000000000000000000000000000000000000000000000111111111
1100000000000000000001000000000000000000000000000000000000000000000001000000000000000000000000000000000000000000000000000000000000000000000000000000001000000010000000000010000000100000000100001000000000000000000000000000000000011100000000000010100010001000100010001000000010000000000001000100010001
1000100010000000110001011000000010111110101111101010001011111010111110101111101011111010110000101111101010000101111101010000101100001011111010111110101111101011111010111110101111101011000000000000000000000000000000000000000000000011101011111010111110101100000000000000000000000000000000000000000001
1000000000000000000000000000011101011111010111110101111101011111010100001011111010111110101111101011111010111110101111101011111010100000000000000000111101111110000000000000000000000001111100000000000000000000000000000000000000000000000000000000000000000000000000000000000000000000000000000011111111
1000000000000000000000100010001000100010000000000000000000000000000000000000000000000000000000000000000000100010001000100010001000100010001000100010001000100010001000100010001000100010001000100010001000100010001000100001000100010001000000000000000000001000100010001000100010001000100010001000100001
1000100010001000100010001000100010001000100010001000100010001000100010001000100010001000100010001000000001110111110101111101010001000100010001000100010001000100010001000100010001000100010001000100000000100100010001000100010001000100010001000100010001000100010001000100010001000100010001000100010001
1000100010001000100010001000100010001000100011000100010001000100010001000100010001000100010001000100010001000100010001000100010001000100010001000100010001000100010001000100010001000100000000100000000000000000000000000000000000000000000000000000000000000000000000000000000000000000000000000000000001
1000000000000000000000000000000000000000000000110000000000000000000000000000000000000000000000000001110101100000000000000000000000000000111010110000000000000000000000000000111010000000000000000001000100010000000010000000000000000000000011100000000000010001000100010001000100010001111101011000000001
1000000000000000000000000000000000000000000011111110111110101111101011111010110000000000000000000000000000011101011110000000000000001010000000000000000000000000011111010111110101111100001000100010001000100010001000100010001000100010001000100010001000100010001000100010001000100010001000100010001001
1010001000100010001000100010001000100010001000000011000000000000000000000000000000000000000000000000000000000000000000001111111111111111111111111111111000000000000000000000000000000000000000000000000000000000000000000000000000000000000000000000000000000000000000000000000000000000000000000000000011
1000000000000000000000000000000000000000000001111111111100000000000000000001000000000000000000000000000000000000000000000001000000000000000000000000000000000000000000000000000000000000000000000000000000001000000010000000000010000000100000000100001000000000000000000000000000N00000011100000000001001
1010001000100010001000100000001000000000000100010001000110001000100000001100010110000000101111101011111010100010111110101111101011111010111110101100001011111010100001011111010100001011000010111110101111101011111010111100000000000000000000000000000000000000000000000000000000000000000000000000001001
1010001000100010001000100010001000100010001000000011000000000000000000000000000000000000000000000000000000000000000000001111111111111111111111111111111000000000000000000000000000000000000000000000000000000000000000000000000000000000000000000000000000000000000000000000000000000000000000000000000011
1010001000100010001000100010001000100010001000000011000000000000000000000000000000000000000000000000000000000000000000001111111111111111111111111111111000000000000000000000000000000000000000000000000000000000000000000000000000000000000000000000000000000000000000000000000000000000000000000000000011
1000000010000000000000000000000000000000000000000000000000000000000000000000000000000000000000000000000000000000000000000000000000000000000000000000000000000000000000000000000000000000000000000000000000000100000001000000000001000000010000000010000100000000000000000000000000000000001110000000000001
1011111010110000001110101111101011111010111110101110000000000000000000000001101011111010111110101100000000000111010111000001010111110101111101011111010100001010111110101000000000101011111010000000000000101111101011111010111110101111101000010111110101111101011111010111110101000010000000000000000001
1111010000000000000000000000000000000000000000000010111110101111000000000000000000001010110000000000000000000000001110101111101011111010111110000000000000000000000000000000000000000000000000000000000000000001000000000000000000000000000000000000000000000000000000000000000000000000000000000000000001
1000000000000000000000000000000000000000000000000000000000000000101110000000000000000000000000000000000000000000011000010001000100010001000100010100010001000100010001000100010001000100010001000100010001000100010001000100010001000100010001000100010001000100010001000100010001000100010001000100010001
1000100010001000100010001000100010001000100010001000100010001000100010001000100010001000100010001000100010001000100010001000100010001000100000000100000000000000000000000000000000000000000000000000000000000000000000000000000000000000000000000000000000000000000000000000000000000000000000000000000001
1000000000000000000000000000000000000000000000000000111010110000000000000000000000000000011101011000000000000000000000000000011101000000000000000000100010001000000001000000000000000000000001110000000000001000100010001000100010001000111110101100000000000000000000000000000000000000000000000000011111
1101111101011111010111110101100000000000000000000000000000111010111100000000000000010100000000000000000000000000111110101111101011111000010001000100010001000100010001000100010001000100010001000100010001000100010001000100010001000100010001000100010001000100010001000100010001000100010001000100000001
1000000000000000000000000000000000000000000000000000000000000000000001111111111111111111111111111111000000000000000000000000000000000000000000000000000000000000000000000000000000000000000000000000000000000000000000000000000000000000000000000000000000000000000000000000000000000000000000000111111111
1100000000000000000001000000000000000000000000000000000000000000000001000000000000000000000000000000000000000000000000000000000000000000000000000000001000000010000000000010000000100000000100001000000000000000000000000000000000011100000000000010100010001000100010001000000010000000000001000100010001
1000100010000000110001011000000010111110101111101010001011111010111110101111101011111010110000101111101010000101111101010000101100001011111010111110101111101011111010111110101111101011000000000000000000000000000000000000000000000011101011111010111110101100000000000000000000000000000000000000000001
1000000000000000000000000000011101011111010111110101111101011111010100001011111010111110101111101011111010111110101111101011111010100000000000000000111101111110000000000000000000000001111100000000000000000000000000000000000000000000000000000000000000000000000000000000000000000000000000000011111111
1000000000000000000000100010001000100010000000000000000000000000000000000000000000000000000000000000000000100010001000100010001000100010001000100010001000100010001000100010001000100010001000100010001000100010001000100001000100010001000000000000000000001000100010001000100010001000100010001000100001
1000100010001000100010001000100010001000100010001000100010001000100010001000100010001000100010001000000001110111110101111101010001000100010001000100010001000100010001000100010001000100010001000100000000100100010001000100010001000100010001000100010001000100010001000100010001000100010001000100010001
1000100010001000100010001000100010001000100011000100010001000100010001000100010001000100010001000100010001000100010001000100010001000100010001000100010001000100010001000100010001000100000000100000000000000000000000000000000000000000000000000000000000000000000000000000000000000000000000000000000001
1000000000000000000000000000000000000000000000110000000000000000000000000000000000000000000000000001110101100000000000000000000000000000111010110000000000000000000000000000111010000000000000000001000100010000000010000000000000000000000011100000000000010001000100010001000100010001111101011000000001
1000000000000000000000000000000000000000000011111110111110101111101011111010110000000000000000000000000000011101011110000000000000001010000000000000000000000000011111010111110101111100001000100010001000100010001000100010001000100010001000100010001000100010001000100010001000100010001000100010001001
1010001000100010001000100010001000100010001000000011000000000000000000000000000000000000000000000000000000000000000000001111111111111111111111111111111000000000000000000000000000000000000000000000000000000000000000000000000000000000000000000000000000000000000000000000000000000000000000000000000011
1000000000000000000000000000000000000000000001111111111100000000000000000001000000000000000000000000000000000000000000000001000000000000000000000000000000000000000000000000000000000000000000000000000000001000000010000000000010000000100000000100001000000000000000000000000000000000011100000000001001
1010001000100010001000100000001000000000000100010001000110001000100000001100010110000000101111101011111010100010111110101111101011111010111110101100001011111010100001011111010100001011000010111110101111101011111010111100000000000000000000000000000000000000000000000000000000000000000000000000001001
1010001000100010001000100010001000100010001000000011000000000000000000000000000000000000000000000000000000000000000000001111111111111111111111111111111000000000000000000000000000000000000000000000000000000000000000000000000000000000000000000000000000000000000000000000000000000000000000000000000011
1010001000100010001000100010001000100010001000000011000000000000000000000000000000000000000000000000000000000000000000001111111111111111111111111111111000000000000000000000000000000000000000000000000000000000000000000000000000000000000000000000000000000000000000000000000000000000000000000000000011
1000000010000000000000000000000000000000000000000000000000000000000000000000000000000000000000000000000000000000000000000000000000000000000000000000000000000000000000000000000000000000000000000000000000000100000001000000000001000000010000000010000100000000000000000000000000000000001110000000000001
1011111010110000001110101111101011111010111110101110000000000000000000000001101011111010111110101100000000000111010111000001010111110101111101011111010100001010111110101000000000101011111010000000000000101111101011111010111110101111101000010111110101111101011111010111110101000010000000000000000001
1111010000000000000000000000000000000000000000000010111110101111000000000000000000001010110000000000000000000000001110101111101011111010111110000000000000000000000000000000000000000000000000000000000000000001000000000000000000000000000000000000000000000000000000000000000000000000000000000000000001
1000000000000000000000000000000000000000000000000000000000000000101110000000000000000000000000000000000000000000011000010001000100010001000100010100010001000100010001000100010001000100010001000100010001000100010001000100010001000100010001000100010001000100010001000100010001000100010001000100010001
1000100010001000100010001000100010001000100010001000100010001000100010001000100010001000100010001000100010001000100010001000100010001000100000000100000000000000000000000000000000000000000000000000000000000000000000000000000000000000000000000000000000000000000000000000000000000000000000000000000001
1000000000000000000000000000000000000000000000000000111010110000000000000000000000000000011101011000000000000000000000000000011101000000000000000000100010001000000001000000000000000000000001110000000000001000100010001000100010001000111110101100000000000000000000000000000000000000000000000000011111
1101111101011111010111110101100000000000000000000000000000111010111100000000000000010100000000000000000000000000111110101111101011111000010001000100010001000100010001000100010001000100010001000100010001000100010001000100010001000100010001000100010001000100010001000100010001000100010001000100000001
1000000000000000000000000000000000000000000000000000000000000000000001111111111111111111111111111111000000000000000000000000000000000000000000000000000000000000000000000000000000000000000000000000000000000000000000000000000000000000000000000000000000000000000000000000000000000000000000000111111111
1100000000000000000001000000000000000000000000000000000000000000000001000000000000000000000000000000000000000000000000000000000000000000000000000000001000000010000000000010000000100000000100001000000000000000000000000000000000011100000000000010100010001000100010001000000010000000000001000100010001
1000100010000000110001011000000010111110101111101010001011111010111110101111101011111010110000101111101010000101111101010000101100001011111010111110101111101011111010111110101111101011000000000000000000000000000000000000000000000011101011111010111110101100000000000000000000000000000000000000000001
1000000000000000000000000000011101011111010111110101111101011111010100001011111010111110101111101011111010111110101111101011111010100000000000000000111101111110000000000000000000000001111100000000000000000000000000000000000000000000000000000000000000000000000000000000000000000000000000000011111111
1000000000000000000000100010001000100010000000000000000000000000000000000000000000000000000000000000000000100010001000100010001000100010001000100010001000100010001000100010001000100010001000100010001000100010001000100001000100010001000000000000000000001000100010001000100010001000100010001000100001
1000100010001000100010001000100010001000100010001000100010001000100010001000100010001000100010001000000001110111110101111101010001000100010001000100010001000100010001000100010001000100010001000100000000100100010001000100010001000100010001000100010001000100010001000100010001000100010001000100010001
1000100010001000100010001000100010001000100011000100010001000100010001000100010001000100010001000100010001000100010001000100010001000100010001000100010001000100010001000100010001000100000000100000000000000000000000000000000000000000000000000000000000000000000000000000000000000000000000000000000001
1000000000000000000000000000000000000000000000110000000000000000000000000000000000000000000000000001110101100000000000000000000000000000111010110000000000000000000000000000111010000000000000000001000100010000000010000000000000000000000011100000000000010001000100010001000100010001111101011000000001
1000000000000000000000000000000000000000000011111110111110101111101011111010110000000000000000000000000000011101011110000000000000001010000000000000000000000000011111010111110101111100001000100010001000100010001000100010001000100010001000100010001000100010001000100010001000100010001000100010001001
1010001000100010001000100010001000100010001000000011000000000000000000000000000000000000000000000000000000000000000000001111111111111111111111111111111000000000000000000000000000000000000000000000000000000000000000000000000000000000000000000000000000000000000000000000000000000000000000000000000011
1000000000000000000000000000000000000000000001111111111100000000000000000001000000000000000000000000000000000000000000000001000000000000000000000000000000000000000000000000000000000000000000000000000000001000000010000000000010000000100000000100001000000000000000000000000000100000011100000000001001
1010001000100010001000100000001000000000000100010001000110001000100000001100010110000000101111101011111010100010111110101111101011111010111110101100001011111010100001011111010100001011000010111110101111101011111010111100000000000000000000000000000000000000000000000000000000000000000000000000001001
1111111111111111111111111111111111111111111111111111111111111111111111111111111111111111111111111111111111111111111111111111111111111111111111111111111111111111111111111111111111111111111111111111111111111111111111111111111111111111111111111111111111111111111111111111111111111111111111111111111111